You are player 2
*****
*1..*
*...*
*2..*  *F**
*...****..*
*....*.._.*
*.__......*
*.........*
***********
